##########
#   . # ##
# $ #   ##
#  # .   #
# #    # #
#  # $   #
#@    #  #
##########