###############
#  #  #    # ##
#      #  $  ##
#  # .   #    #
#    @ #   ## #
#  # $    .   #
#  #  #   #   #
###############