    #####
    #   #
    #$ $#
  ###   ##
  #   $  #
### #$## #   #######
#   # ## #####   ..#
# $   $          ..#
##### ### #@##   ..#
    #     ##########
    #######         