    #####        
    #   #                
    #$  #                     
  ###  $##                    
  #  $ $ #
### # ## #   #######
#   # ## #####   ..#
# $  $           ..#
##### ### #@##   ..#
    #     ##########
    #######         